0,0,63,0,0,64,58,64,63,57,58,63,0,57,0,0,64,57,63,63,3,3,3,3,3,3,3,3,3,3,3,3,3,3,3,3,3,3,3,3,3,3,3,3,3,3,3,3,3,3,3,3,3,3,3,3,3,3,3,3,3,3,3,3,3,3,3,3,3,3,0,0,64,57,57,0,0,0,64,63,0,0,0,64,58,0,0,63,0,57,57,
57,3,3,3,3,3,3,3,3,3,3,3,3,3,3,3,3,3,64,3,3,3,3,3,3,3,3,3,3,3,3,3,3,3,3,3,3,3,3,3,3,3,3,3,3,3,3,3,3,3,3,3,3,3,3,3,3,3,3,3,3,0,57,57,57,58,64,64,63,58,0,0,0,57,57,0,0,0,64,64,58,0,64,58,58,64,64,63,58,0,64,
57,3,3,3,3,3,3,3,3,3,3,3,3,3,3,3,3,3,64,3,3,3,3,3,3,3,3,3,3,3,3,3,3,3,3,3,3,3,3,3,3,3,3,3,3,3,3,3,3,3,3,3,3,3,3,3,3,3,3,3,3,3,3,64,0,58,64,63,63,0,57,0,0,64,0,0,64,0,64,63,0,63,58,0,64,57,63,57,64,58,64,
0,3,3,3,3,3,3,3,3,3,3,3,3,3,3,3,3,3,63,3,3,3,3,3,3,3,3,3,3,3,3,3,3,3,3,0,0,3,3,3,3,3,3,3,58,0,64,57,3,3,3,3,3,3,3,3,3,3,3,3,3,3,3,3,3,0,0,0,57,0,57,57,0,64,63,63,0,0,0,57,64,0,0,0,63,57,57,0,63,0,57,
63,3,3,3,3,3,3,3,3,3,3,3,3,3,3,3,3,3,0,3,3,3,3,3,3,3,3,3,3,3,3,3,3,3,3,3,3,3,3,3,3,3,3,3,3,3,3,3,3,3,3,3,3,3,3,3,3,3,3,3,3,3,3,3,3,3,3,0,63,58,0,64,64,63,64,64,63,0,58,64,64,64,64,0,57,64,0,0,57,0,63,
0,3,3,3,3,3,3,3,3,0,58,63,57,166,167,0,3,3,63,3,3,166,167,63,64,57,3,3,3,3,3,3,3,3,3,3,3,3,3,3,3,3,3,3,3,3,3,3,3,3,3,3,3,3,3,3,3,3,3,3,3,3,3,3,3,3,3,3,58,58,63,63,0,0,0,0,64,0,0,57,0,58,58,0,0,57,57,57,64,0,64,
63,3,3,3,3,3,3,3,58,64,58,57,57,166,167,0,3,3,63,3,3,166,167,0,0,0,57,3,3,3,3,3,3,3,3,3,3,3,63,3,3,3,3,3,3,3,3,3,3,3,3,3,3,3,3,3,3,3,3,3,3,3,3,3,3,3,3,3,3,0,0,64,63,0,58,0,0,58,0,0,64,0,57,58,58,58,0,0,58,0,0,
63,3,3,3,3,3,3,3,0,0,63,0,64,0,166,167,58,57,0,57,0,57,166,167,0,57,0,63,3,3,3,3,3,3,3,3,3,3,3,3,3,3,3,3,3,3,3,63,0,3,3,3,63,3,3,63,3,3,3,3,3,3,3,3,3,3,3,3,3,3,0,57,64,63,57,64,0,63,58,58,0,57,0,63,58,0,57,63,0,63,0,
58,3,3,3,3,3,57,57,58,57,63,64,0,63,166,167,64,63,63,57,64,0,166,167,57,57,164,165,63,57,3,3,3,3,3,3,3,3,3,3,3,3,3,58,0,58,0,58,0,0,58,58,63,58,57,0,63,0,63,58,0,3,3,3,3,3,3,3,3,3,0,64,0,58,0,57,64,57,57,64,58,63,63,64,57,0,63,58,0,63,0,
58,3,3,3,3,58,63,64,63,0,58,57,0,63,64,166,167,57,63,63,0,0,0,166,167,64,166,167,63,164,165,63,3,3,3,3,3,3,3,3,58,0,63,58,0,58,0,0,58,0,58,63,58,0,0,0,58,58,58,63,58,58,63,0,3,3,3,3,3,3,3,63,57,64,0,64,63,0,63,58,64,57,64,0,64,63,0,64,0,64,0,
57,3,3,3,58,0,0,64,57,0,58,0,63,58,64,166,167,58,0,63,57,0,0,166,167,63,57,0,0,166,167,0,0,0,3,3,3,3,3,58,0,57,63,0,58,64,64,0,58,63,57,64,57,58,0,63,58,0,63,57,58,64,57,64,0,3,3,3,3,3,3,58,57,63,0,58,0,0,0,57,0,63,63,64,0,63,58,64,0,64,0,
0,3,3,63,0,63,0,63,58,0,58,0,64,58,166,167,57,0,0,0,58,63,57,58,166,167,63,63,57,64,0,58,0,64,63,0,3,3,0,57,0,0,0,64,63,58,0,58,0,0,58,0,0,63,63,58,0,0,63,0,64,0,0,63,0,58,3,3,3,3,3,3,57,0,0,58,57,58,0,63,58,63,63,57,57,64,0,64,64,57,57,
0,3,3,3,63,0,0,0,57,57,63,0,0,0,166,167,64,63,0,58,58,58,0,58,166,167,64,57,0,0,57,57,0,57,63,58,57,0,58,63,58,57,0,57,57,63,63,0,64,63,58,64,58,64,58,58,58,58,0,0,64,0,57,0,63,64,0,3,3,3,3,3,0,64,57,63,57,58,63,64,63,63,58,0,63,63,57,58,0,0,64,
57,3,3,3,63,0,57,64,0,64,58,57,0,166,167,57,64,63,64,64,0,64,64,166,167,0,0,57,58,0,0,0,0,0,0,0,0,58,58,57,0,0,92,92,92,92,0,92,89,58,58,57,0,0,0,0,166,167,57,63,63,58,63,0,63,58,57,3,3,3,3,3,3,63,0,0,64,63,58,63,58,64,57,57,57,64,64,57,64,0,0,
64,3,3,3,64,63,58,0,0,0,0,63,0,0,64,0,57,57,0,0,63,63,0,0,57,0,64,63,0,57,63,0,0,63,64,63,63,0,0,58,88,89,57,63,57,63,0,166,167,58,64,0,0,0,63,166,167,166,167,63,58,0,58,58,58,58,64,0,58,3,3,3,3,64,64,58,63,63,64,57,57,57,58,0,63,58,63,0,63,0,57,
63,3,3,3,0,0,57,0,57,63,166,167,166,167,166,167,63,58,63,0,64,58,166,167,166,167,166,167,166,167,166,167,166,167,0,58,58,57,64,88,89,0,0,63,0,64,166,167,166,167,57,0,0,57,166,167,166,167,64,63,58,63,63,0,64,63,58,57,64,3,3,3,3,0,58,0,63,58,0,63,57,64,58,0,64,0,63,58,0,58,63,
0,3,3,3,63,63,58,58,0,166,167,166,167,166,167,64,64,0,58,0,57,63,63,166,167,166,167,166,167,166,167,166,167,166,167,165,0,64,88,89,63,63,58,57,0,166,167,166,167,166,167,57,64,166,167,166,167,58,63,0,0,64,58,64,63,64,64,58,0,63,3,3,3,3,63,0,63,0,64,64,58,0,57,0,63,63,63,0,0,58,0,
63,3,3,3,0,0,0,57,0,0,166,167,166,167,0,0,0,58,0,0,63,57,58,63,166,167,166,167,166,167,166,167,166,167,166,167,57,88,89,64,63,0,0,63,166,167,166,167,166,167,0,57,166,167,166,167,91,64,0,63,63,58,0,58,0,64,64,0,58,57,57,3,3,3,57,0,0,63,64,63,57,63,58,58,58,0,0,57,0,58,64,
0,3,3,3,0,0,92,92,92,92,0,0,0,0,88,92,64,0,0,57,0,63,57,63,0,166,167,166,167,166,167,166,167,57,0,0,88,89,0,63,63,0,57,166,167,166,167,166,167,64,57,0,58,166,167,166,167,58,63,64,0,0,0,0,0,57,57,0,0,0,64,3,3,3,63,64,0,57,0,58,58,64,58,0,0,0,58,0,0,0,57,
63,3,3,3,0,57,58,0,88,89,63,0,0,88,89,0,0,0,0,57,57,88,89,64,0,0,64,166,167,166,167,166,167,63,0,88,89,0,63,64,0,0,166,167,166,167,166,167,58,0,0,64,58,0,166,167,166,167,166,167,166,167,166,167,64,0,57,63,58,0,0,58,3,3,0,64,0,0,63,0,57,57,0,57,57,58,57,57,0,57,0,
0,3,3,3,3,58,0,88,89,64,57,0,88,89,58,64,0,63,0,63,88,89,166,167,0,0,166,167,166,167,166,167,64,0,88,89,63,58,58,0,0,166,167,166,167,166,167,166,167,57,57,63,58,0,58,166,167,166,167,166,167,166,167,166,167,64,63,0,0,63,0,0,3,3,58,57,57,57,58,64,0,0,0,0,58,57,0,0,64,0,57,
57,3,3,3,3,58,58,91,92,92,92,92,89,58,63,63,57,0,57,88,89,166,167,0,0,166,167,166,167,166,167,58,58,88,89,58,57,63,58,0,0,0,166,167,166,167,166,167,57,57,0,57,63,63,63,58,57,64,57,57,0,0,63,57,63,0,64,58,58,58,64,63,3,3,0,0,64,57,63,0,64,64,57,0,58,58,63,57,64,0,57,
63,3,3,3,3,3,0,0,63,58,58,0,0,63,63,0,58,0,88,89,166,167,58,64,166,167,166,58,166,167,63,58,88,89,0,57,64,0,58,57,63,64,0,63,63,64,57,166,167,166,167,166,167,57,167,166,167,0,64,0,57,64,0,57,63,0,0,58,64,64,63,57,3,3,0,0,58,63,0,57,64,57,64,0,57,0,57,57,0,58,63,
63,3,3,3,3,3,3,3,64,0,57,0,63,58,57,63,0,88,89,166,167,57,0,64,57,64,0,58,57,0,58,88,89,0,58,63,57,63,58,166,167,63,63,0,63,57,166,167,166,167,166,64,166,167,166,167,166,167,63,0,58,58,64,64,0,0,63,57,0,0,57,3,3,3,63,57,0,57,57,63,0,0,63,0,58,57,63,58,58,0,0,
57,3,3,3,3,3,3,3,3,63,0,64,0,58,63,57,88,89,166,167,0,57,0,63,64,63,0,63,58,63,88,89,63,58,63,0,57,57,166,167,166,167,58,0,0,0,63,166,167,166,167,166,167,0,58,64,0,64,0,58,57,58,58,0,0,58,63,57,0,3,3,3,3,3,57,0,0,63,0,0,0,58,64,0,57,57,0,58,64,57,0,
63,3,3,3,3,3,3,3,3,64,63,0,63,58,64,88,89,166,167,0,0,166,167,166,167,64,0,63,92,92,89,0,63,63,0,0,57,166,167,166,167,166,167,0,166,167,166,167,166,167,166,167,64,0,0,63,0,0,57,58,63,58,58,0,63,63,64,57,57,3,3,3,3,57,64,0,63,64,57,0,0,0,63,0,0,58,0,0,0,0,58,
57,3,3,3,3,3,3,3,3,3,3,64,0,58,88,89,166,167,58,57,166,167,166,167,166,167,0,0,0,58,58,57,64,58,64,57,166,167,166,167,166,167,64,0,57,166,167,166,167,58,64,57,58,58,0,63,63,58,0,0,57,64,0,64,3,3,3,3,3,3,3,3,0,57,57,0,64,58,64,0,64,0,0,0,0,0,0,64,0,63,0,
64,3,3,3,3,3,3,3,3,3,3,0,58,88,89,166,167,64,0,64,63,166,167,166,167,63,0,57,57,57,0,63,63,0,0,166,167,166,167,166,167,0,58,0,0,64,0,58,0,57,63,63,64,64,63,57,0,57,63,0,63,58,58,0,3,3,3,3,3,3,57,58,58,0,0,58,58,63,0,63,0,63,57,63,58,63,57,64,0,0,64,
0,3,3,3,3,3,3,3,3,3,3,3,57,0,166,167,58,64,166,167,166,167,166,167,166,167,58,0,58,0,0,57,0,63,166,167,166,167,166,167,58,57,64,0,0,0,0,57,0,0,57,58,0,64,0,0,63,0,58,58,57,0,64,64,3,3,3,3,0,64,0,63,58,57,0,63,0,57,63,64,58,63,0,0,58,0,63,0,64,58,0,
64,3,3,3,3,3,3,3,3,3,3,3,0,0,0,57,58,58,63,0,0,57,0,64,0,0,57,166,167,166,167,166,167,166,167,166,167,166,167,166,167,166,167,166,167,166,167,166,167,166,167,166,167,166,167,57,58,0,64,58,0,64,63,3,3,3,3,63,63,63,0,0,0,0,0,0,64,57,0,64,0,58,0,64,63,58,63,0,58,63,0,
64,3,3,3,3,3,3,3,3,3,3,3,3,57,57,0,63,63,0,63,64,0,64,64,166,167,166,167,166,167,166,167,166,167,166,167,166,167,166,167,166,167,166,167,166,167,166,167,166,167,166,167,166,167,57,0,58,63,0,63,58,58,0,3,3,3,3,0,0,63,0,58,64,0,58,63,64,58,58,0,58,0,64,0,64,57,58,63,58,57,64,
58,3,3,3,3,3,3,3,3,3,3,3,3,0,0,0,0,57,64,63,0,63,0,166,167,166,167,166,167,166,167,166,167,166,167,166,167,0,0,64,64,58,0,63,57,63,0,57,0,0,63,0,0,0,0,0,0,0,64,0,0,57,3,3,3,3,0,0,57,0,64,0,0,63,0,63,64,0,0,0,57,0,58,58,64,63,58,57,58,63,0,
0,3,3,3,3,3,3,3,3,3,3,3,3,3,64,58,58,64,58,0,64,57,166,167,166,167,166,167,166,167,166,167,166,167,166,167,64,57,63,64,63,0,63,0,58,58,63,0,63,63,0,57,57,64,0,63,0,57,57,58,58,0,3,3,3,3,0,63,0,0,64,58,0,63,0,58,0,57,63,64,63,0,64,0,58,57,57,0,58,57,0,
58,3,3,3,3,3,3,3,3,3,3,3,3,3,3,0,64,58,0,0,57,0,63,57,64,0,63,58,63,63,0,0,57,63,0,0,0,0,0,63,63,58,3,3,57,3,3,0,58,0,64,0,0,57,64,0,0,0,0,57,64,3,3,3,3,0,64,64,0,57,63,57,0,58,0,0,0,64,64,0,64,58,0,64,63,0,63,0,58,64,0,
63,3,3,3,3,3,3,3,3,3,3,3,3,3,3,3,63,58,64,57,0,0,0,0,0,64,0,0,58,64,64,64,57,58,57,63,0,57,0,0,3,3,3,3,3,3,3,3,3,3,57,58,57,57,58,63,63,58,63,58,3,3,3,3,64,58,58,0,0,64,0,64,63,0,0,0,57,0,0,58,64,57,0,0,0,64,58,58,0,64,0,
58,3,3,3,3,3,3,3,3,0,0,3,3,3,3,3,3,3,58,0,0,57,57,0,0,0,0,63,0,0,64,63,0,57,57,0,63,3,3,3,3,3,3,3,3,3,3,3,3,3,3,0,57,58,0,58,63,0,64,3,3,3,3,3,0,63,0,63,0,0,57,64,64,58,64,0,0,58,63,63,0,0,64,57,64,0,0,0,0,0,57,
58,3,3,3,3,3,3,3,3,3,3,0,3,3,3,3,3,3,3,3,0,0,57,57,58,63,58,0,0,64,63,64,64,63,3,3,3,3,3,3,3,3,3,3,3,3,3,3,3,3,3,3,3,57,64,57,0,3,3,3,3,3,3,64,57,64,0,0,0,63,57,0,63,64,57,64,63,58,0,64,58,57,63,0,58,0,64,64,58,0,63,
57,3,3,3,3,3,3,3,3,3,3,3,63,0,3,3,3,3,3,3,3,3,0,0,64,58,3,3,63,3,3,3,3,3,3,3,3,3,3,3,3,3,3,3,3,3,3,3,3,3,3,3,3,3,3,3,3,3,3,3,3,3,3,0,64,63,64,64,0,64,57,64,0,58,0,64,0,0,58,58,58,0,63,57,57,0,64,64,64,57,57,
64,3,3,3,3,3,3,3,3,3,3,3,3,3,3,3,3,3,3,3,3,3,3,3,3,3,3,3,3,3,3,3,3,3,3,3,3,3,3,3,3,57,3,3,3,3,3,63,3,3,3,3,3,3,3,3,3,3,3,3,3,63,63,58,0,63,57,58,63,57,0,63,64,57,0,0,0,57,0,57,0,63,63,63,0,0,57,63,57,64,63,
57,3,3,3,3,3,3,3,3,3,3,3,3,3,3,3,3,3,3,3,3,3,3,3,3,3,3,3,3,3,3,3,3,3,3,3,0,3,3,3,3,3,3,3,3,3,3,3,3,3,3,3,3,3,3,3,3,3,3,3,58,63,0,64,0,0,0,63,0,57,0,64,0,63,64,63,63,58,63,0,64,63,0,0,64,57,64,58,57,0,0,
57,64,0,0,63,3,3,3,3,3,3,3,3,3,3,3,3,3,3,3,3,3,3,3,3,3,3,3,3,3,3,3,3,3,3,3,3,3,3,3,3,3,3,3,3,3,3,3,3,3,3,3,3,3,3,3,3,3,3,3,63,64,0,0,0,58,0,64,57,63,63,63,0,58,57,0,64,63,0,63,0,0,64,64,57,63,57,63,64,0,0,
58,63,64,58,0,0,57,58,0,58,63,57,57,0,63,0,57,64,0,58,0,0,58,57,58,0,3,3,3,3,3,3,3,3,3,3,3,3,3,3,3,3,64,0,0,0,63,0,0,64,57,0,0,63,58,58,63,64,64,57,64,0,0,57,0,0,64,57,63,0,58,64,0,0,58,57,63,0,0,0,64,63,0,58,64,58,0,0,58,0,57,
63,0,63,0,0,0,57,57,64,0,0,58,63,63,63,64,64,0,0,57,0,63,64,63,0,0,64,0,0,64,64,0,64,0,0,63,0,63,57,63,64,0,57,57,0,0,0,0,0,64,57,63,64,58,0,58,63,64,0,64,0,0,57,63,57,57,57,64,0,0,0,58,0,57,57,0,0,58,57,57,64,57,64,0,0,57,63,0,64,0,57,
64,0,64,64,0,58,63,57,0,0,57,0,63,0,57,0,0,64,63,58,63,0,0,57,57,64,0,0,58,63,63,0,0,0,0,0,63,58,58,57,0,64,58,64,58,0,0,0,64,58,63,64,64,58,58,64,0,63,0,64,57,0,0,0,0,0,0,64,57,0,0,63,63,64,64,58,57,64,64,63,0,0,0,0,64,58,0,64,57,64,63,
57,0,64,63,57,64,0,0,0,64,63,0,63,0,0,58,63,58,58,0,63,0,0,0,64,57,63,58,64,63,57,63,0,64,64,58,0,63,58,63,58,63,0,0,0,58,64,64,0,63,57,0,0,63,0,63,64,0,0,0,58,57,58,58,64,0,57,58,0,64,64,58,64,57,63,0,0,64,58,57,63,0,0,63,64,0,0,63,57,0,64,
64,58,58,0,0,0,57,0,64,0,0,0,0,0,0,63,0,58,0,63,0,63,0,57,64,0,58,58,58,0,63,0,63,0,57,63,0,57,58,63,63,64,64,64,58,63,64,57,0,0,0,63,63,63,0,58,57,64,63,57,0,63,64,0,58,0,64,0,0,58,63,63,0,0,64,0,63,0,0,0,0,63,58,63,0,57,58,57,64,58,0,
64,63,0,64,64,63,64,63,64,64,64,64,0,58,0,63,0,64,63,0,57,0,0,63,57,0,0,0,0,58,64,63,64,58,0,57,64,64,0,0,58,0,57,0,64,57,63,0,0,0,0,0,57,57,0,0,63,0,57,0,57,0,63,0,64,64,57,0,0,0,64,0,0,57,58,57,0,64,0,64,63,0,0,58,57,0,57,0,64,64,63,
63,64,58,63,57,63,64,63,0,64,0,57,64,57,64,63,0,0,58,63,63,63,63,0,58,0,64,57,58,0,63,0,0,0,57,0,63,63,0,63,0,0,0,58,0,0,63,57,0,58,0,64,64,64,0,63,0,58,58,57,64,0,57,0,57,0,57,0,63,58,0,0,0,63,64,58,0,64,0,58,63,57,57,57,64,0,64,58,0,63,0,
57,64,0,64,63,63,0,63,0,64,57,63,0,64,58,0,0,64,58,58,57,57,63,64,58,63,0,63,64,0,63,63,0,64,58,57,0,0,0,57,64,57,57,0,57,58,0,64,0,63,0,0,64,58,0,0,0,0,63,63,64,58,0,0,58,58,0,0,64,63,63,57,63,57,64,64,58,63,58,57,0,0,57,0,58,0,57,0,64,64,0,
63,0,58,63,58,0,57,57,58,0,63,0,57,57,58,64,64,63,63,0,0,63,58,63,0,58,0,0,0,58,64,57,64,58,0,0,58,57,0,63,0,58,0,64,0,0,57,63,0,0,58,0,64,64,0,57,0,58,64,0,63,58,64,64,64,63,58,0,64,58,64,64,64,0,57,57,64,0,63,58,63,57,0,63,63,58,0,63,63,0,57,
58,63,58,0,58,57,57,64,0,64,57,57,63,63,58,57,64,57,57,58,0,57,63,57,58,63,63,0,57,0,57,63,0,64,57,57,57,0,58,0,57,63,64,0,57,58,57,57,57,64,64,0,0,58,58,0,58,64,63,63,63,0,63,0,64,0,0,0,63,0,0,63,58,64,0,0,57,64,57,0,0,63,64,64,58,0,0,63,57,0,57,
57,63,58,57,0,0,57,0,64,57,63,58,0,57,0,0,0,63,58,63,0,0,58,0,63,0,0,0,0,0,58,57,64,0,64,0,0,63,0,64,0,58,63,0,58,58,57,63,0,63,63,0,63,0,57,0,0,63,63,63,0,63,64,63,0,64,0,57,63,63,0,0,0,63,0,0,57,0,57,64,63,63,63,0,0,58,57,58,64,64,0,
64,63,63,63,57,0,0,0,0,64,0,57,0,64,58,0,57,0,64,0,58,58,0,0,0,58,0,0,63,58,64,64,57,0,64,0,57,63,0,58,64,63,57,0,64,58,0,63,63,57,57,58,63,63,0,58,0,0,0,64,57,0,57,0,57,57,64,57,58,0,64,64,63,57,64,64,64,64,0,58,63,57,64,0,64,57,64,58,0,57,64,
63,0,0,64,0,57,0,0,64,0,63,64,0,0,58,58,0,64,0,0,58,58,0,0,0,58,58,63,64,64,63,0,63,0,64,0,58,58,0,58,0,64,0,57,64,0,64,57,57,57,64,58,58,57,58,58,0,0,0,0,57,57,0,58,63,58,64,0,63,64,57,0,0,63,58,0,64,0,58,58,58,63,63,63,0,57,57,58,0,58,0,
63,0,0,0,58,63,58,57,64,0,64,0,58,0,57,64,58,0,58,64,0,0,63,0,0,57,0,63,0,0,64,0,0,0,63,57,64,57,0,63,63,64,0,63,58,64,57,0,0,64,0,57,0,0,58,0,0,0,0,57,0,58,64,58,64,63,58,57,64,58,64,0,0,63,57,57,0,0,0,0,57,58,0,0,0,58,63,0,0,0,0,
63,0,63,0,64,0,63,63,63,57,0,57,64,64,63,63,64,57,0,57,0,63,0,64,0,0,57,63,63,64,58,58,58,58,63,0,58,0,0,58,57,58,0,0,0,0,63,63,57,64,0,0,0,57,58,63,57,63,64,0,57,64,63,64,58,58,0,57,0,63,0,0,58,58,63,57,0,57,57,57,64,0,64,0,0,63,58,63,0,0,0,
57,64,58,0,64,0,0,64,0,0,58,58,64,57,58,58,58,0,63,64,58,58,63,58,64,63,63,0,0,63,0,64,0,57,0,58,58,0,0,63,64,0,0,63,0,0,63,0,64,64,0,64,64,64,0,63,57,58,0,63,63,57,57,63,0,0,64,58,64,64,57,0,0,0,64,57,57,0,0,64,63,63,0,64,64,0,58,0,0,58,63,
57,63,64,64,0,0,57,57,0,58,0,63,58,0,58,0,63,0,63,58,57,0,0,0,63,58,64,57,0,0,57,0,64,0,0,0,64,0,58,64,0,63,58,64,58,63,0,57,0,64,0,63,0,63,58,64,58,0,0,57,0,63,0,58,0,63,63,57,64,0,63,0,58,64,58,64,58,63,58,0,57,57,63,0,64,0,57,58,0,0,0,
0,58,0,58,0,0,64,64,64,63,58,57,64,64,63,64,57,58,0,58,0,57,57,63,63,64,58,0,63,0,63,57,58,58,63,57,0,63,64,0,0,63,64,0,57,0,57,63,58,63,63,0,64,0,0,58,57,58,0,57,0,58,57,58,0,64,64,57,64,64,57,0,63,0,0,58,63,0,58,0,64,64,63,0,63,57,64,64,57,0,0,
0,64,0,64,0,0,0,0,64,63,63,0,63,57,0,57,64,0,63,0,58,63,57,0,64,0,0,0,0,57,57,0,64,58,63,0,57,58,64,58,0,0,58,63,63,58,0,0,0,0,64,57,57,0,64,64,64,58,58,63,63,0,0,0,0,0,0,64,0,63,64,63,0,64,63,0,57,57,64,63,0,63,0,64,64,0,0,0,57,0,0,
58,64,64,64,0,0,64,0,0,64,64,58,64,0,63,0,0,0,0,57,64,64,0,63,58,57,58,63,58,58,57,57,0,0,64,57,0,0,58,58,57,63,57,63,57,64,57,0,58,57,57,0,58,58,0,57,0,63,58,0,58,0,0,64,0,57,57,63,58,0,57,63,64,58,64,63,58,57,0,64,0,63,0,63,57,63,57,63,63,0,0,
64,64,64,63,57,63,57,58,0,63,58,0,64,57,63,0,0,64,0,64,57,0,57,0,57,0,57,0,63,64,58,57,63,57,0,63,0,0,58,0,64,63,0,63,64,57,0,0,57,57,0,58,0,57,64,57,57,58,63,63,63,57,58,64,0,57,57,64,0,0,58,64,0,0,57,0,0,57,0,57,63,63,64,63,58,58,58,64,64,58,58,
0,64,58,64,58,63,0,63,0,64,57,64,63,0,0,58,58,0,58,63,64,64,57,58,58,64,0,57,64,63,0,58,0,58,57,0,64,63,57,63,0,57,0,0,58,64,64,0,0,63,0,63,57,64,0,0,0,0,0,63,58,0,0,57,57,64,64,58,64,57,58,57,63,0,63,0,64,64,57,63,58,63,63,57,58,64,57,63,0,63,0,
0,63,57,64,0,64,64,0,58,0,0,0,63,0,64,0,0,64,57,64,63,63,64,58,0,0,64,63,64,0,0,58,0,0,0,57,63,0,63,0,58,0,0,58,64,64,0,0,58,57,0,58,64,0,0,0,57,0,0,64,58,57,58,63,57,0,57,0,63,0,57,0,63,0,63,64,57,58,0,63,63,64,63,0,57,0,64,64,57,57,0,
63,57,63,58,57,64,0,58,64,63,63,57,0,63,63,57,0,58,57,58,58,64,57,63,57,0,58,63,64,0,0,58,64,0,64,64,64,0,63,57,57,0,63,0,58,63,58,0,58,63,63,57,63,0,0,63,58,0,0,57,58,64,64,58,63,0,63,0,64,64,0,0,63,57,0,0,63,0,57,0,57,64,63,0,0,0,57,0,0,63,0,
57,63,0,64,0,0,64,64,0,0,58,57,0,64,0,0,0,57,63,0,57,58,0,0,63,0,0,57,63,0,63,0,0,64,57,0,0,0,63,63,0,57,0,0,58,58,64,0,63,0,63,64,0,64,0,57,64,0,58,63,0,64,58,64,0,58,0,0,0,58,57,0,58,63,64,58,57,63,57,0,0,63,0,58,64,0,58,0,58,64,57,
0,0,57,0,64,0,63,0,0,63,57,63,58,64,63,64,57,63,0,0,0,57,0,0,64,63,0,63,64,0,64,58,0,63,63,58,63,58,0,58,58,63,0,0,57,0,63,64,57,0,0,58,57,0,64,64,57,63,57,0,0,63,57,64,58,57,58,64,0,63,0,63,64,64,0,63,0,0,63,63,0,0,64,57,0,58,0,63,57,64,57,
0,58,58,0,0,0,64,64,0,63,0,0,0,0,57,63,57,63,63,0,58,63,58,0,63,0,0,64,58,0,0,0,0,57,0,63,63,64,58,0,57,64,58,0,0,63,58,64,57,63,57,64,57,0,63,57,0,58,63,0,64,58,64,58,0,63,0,64,63,0,0,58,58,0,58,64,63,63,0,63,0,0,58,63,57,57,0,0,58,63,63,
64,0,0,63,63,63,0,58,63,0,57,58,0,58,0,0,0,0,57,63,57,63,63,63,0,57,64,58,58,0,63,58,63,57,58,64,0,63,63,0,64,0,58,64,0,64,64,58,58,0,0,0,63,63,0,0,63,0,57,57,63,0,0,0,0,63,57,0,0,57,0,0,0,57,0,64,57,57,63,57,0,0,58,58,0,0,64,0,0,0,64,
57,58,57,0,63,64,0,0,63,0,57,63,63,0,63,0,58,0,64,64,0,63,64,58,58,57,64,0,57,57,0,64,63,0,0,58,64,57,0,0,0,57,57,57,64,58,63,58,0,64,57,0,57,0,63,0,0,63,57,0,64,64,57,0,0,57,0,0,0,63,57,0,58,57,57,58,57,0,58,57,0,64,64,57,0,0,63,58,64,58,57,
57,58,58,58,64,58,57,64,63,0,64,64,58,63,0,63,0,58,57,0,63,64,0,0,64,63,57,57,0,0,57,64,58,57,58,58,0,57,64,64,63,63,58,0,0,0,0,63,0,63,0,0,58,63,57,64,64,64,58,64,0,0,58,63,64,0,63,0,0,0,0,0,57,64,0,0,63,63,64,0,63,0,64,63,58,57,0,64,57,63,0,
0,64,58,64,0,0,57,0,0,64,0,58,58,64,64,64,58,0,0,58,0,63,58,0,58,64,57,63,57,0,0,63,57,57,0,64,64,0,0,64,0,57,64,0,64,0,58,63,57,58,57,0,63,64,58,63,0,58,63,63,57,64,0,57,57,57,0,0,64,64,0,63,64,57,64,0,0,58,0,63,0,63,0,57,63,64,0,64,63,63,64,
63,0,63,58,57,64,58,63,58,63,57,63,63,0,58,64,0,57,64,57,0,0,58,64,0,0,58,0,58,58,0,63,64,0,63,0,0,64,64,58,0,0,63,58,57,58,0,63,63,64,58,0,63,0,64,0,0,0,58,0,63,0,57,57,0,0,57,57,63,0,0,58,0,57,58,63,64,0,57,0,63,0,0,57,0,63,64,0,0,63,0,
57,0,63,57,64,57,0,63,0,58,64,64,58,64,0,64,0,57,58,0,57,57,64,63,0,0,58,63,63,57,64,63,58,63,64,0,0,0,57,0,58,63,57,58,64,58,58,0,0,58,0,63,64,63,0,58,58,57,0,0,64,0,57,0,64,0,0,58,58,58,63,57,0,0,64,64,57,0,64,0,0,64,0,0,64,0,63,57,57,0,64,
64,57,63,0,63,64,58,57,58,0,58,63,0,64,0,64,64,0,64,64,57,0,0,0,64,58,64,63,0,58,57,63,0,0,0,0,63,64,64,0,57,57,0,57,0,64,58,0,63,0,0,64,58,58,64,63,57,63,63,63,63,64,0,0,57,58,57,58,0,0,58,0,63,57,57,57,58,0,0,0,0,0,57,58,0,0,64,58,57,58,58,
63,0,0,57,64,58,0,0,0,58,63,0,63,57,63,64,0,64,58,63,0,63,63,0,0,0,63,58,64,63,0,0,64,63,58,58,64,0,58,0,64,0,58,57,0,0,0,63,57,64,63,0,0,0,58,63,57,58,58,58,63,0,0,58,58,0,58,63,58,0,63,58,0,0,63,64,58,0,63,0,64,0,63,58,0,63,63,64,57,63,0,
0,64,63,64,58,57,63,0,0,58,0,0,0,0,63,0,63,58,57,57,0,0,58,58,64,63,64,0,58,57,0,58,57,0,58,57,0,64,64,0,57,0,0,57,64,64,0,64,64,0,57,58,0,0,63,0,58,0,64,0,0,64,64,0,0,58,57,64,58,0,0,57,0,0,0,63,57,58,58,0,0,0,63,63,0,0,57,0,57,58,0,
64,58,0,63,58,58,64,58,63,64,64,0,63,64,63,0,64,0,0,0,57,0,63,64,0,0,63,64,63,58,57,57,58,57,58,63,0,0,57,64,63,0,57,57,58,0,57,63,64,58,0,64,0,57,0,57,57,0,57,0,58,64,64,64,0,0,63,64,0,0,64,64,0,57,57,58,0,58,0,0,63,0,0,63,0,0,64,58,57,0,64,
57,64,63,0,63,64,0,58,0,0,57,0,0,0,64,63,0,63,0,0,0,0,0,57,57,57,0,0,58,57,57,57,58,58,58,0,58,0,57,58,57,0,64,63,57,57,0,63,0,0,64,0,57,0,58,0,58,0,64,0,63,0,58,63,63,63,0,64,0,0,58,57,58,0,58,63,63,64,0,57,63,63,0,64,0,58,0,57,0,0,0,
63,0,64,63,58,57,0,57,64,57,0,63,63,0,64,64,0,63,0,58,0,58,0,63,57,0,0,63,0,64,58,58,63,0,63,57,64,0,0,57,0,0,63,0,63,0,63,57,0,0,64,0,57,58,0,57,58,63,63,0,64,63,0,63,64,64,58,57,0,58,58,58,0,63,58,0,63,57,63,0,64,63,0,64,0,0,57,0,0,63,0,
58,58,64,0,64,58,57,0,57,64,64,58,64,64,0,64,0,63,57,58,63,57,64,63,64,0,58,0,0,57,0,58,64,64,64,63,58,63,0,58,0,57,0,58,63,57,64,63,58,0,0,57,0,58,57,57,64,0,0,57,63,0,57,63,57,58,63,58,0,0,0,0,0,0,57,63,64,58,63,0,0,57,0,57,0,63,57,0,58,57,0,
57,57,0,64,57,58,57,57,64,0,0,64,58,0,0,58,58,63,0,57,63,0,57,63,0,57,64,0,57,64,63,58,64,58,64,0,63,0,0,64,63,0,63,0,58,0,63,57,0,64,0,58,0,0,0,57,64,63,57,57,0,63,57,0,58,58,58,64,63,63,0,57,63,58,57,0,63,0,58,63,0,0,58,0,0,57,63,0,57,0,0,
63,63,63,0,0,63,63,57,0,0,0,63,0,57,64,58,0,0,64,0,57,58,0,58,63,0,64,64,57,63,63,63,64,0,63,0,57,0,58,63,64,63,0,0,0,58,0,63,57,0,64,57,63,0,0,63,58,58,63,63,63,0,64,58,57,64,0,58,57,64,58,57,64,0,64,63,58,63,0,58,0,0,0,57,57,64,0,0,0,0,64,
58,0,0,57,63,0,63,57,0,58,0,63,64,0,0,0,0,0,63,64,0,0,0,0,58,64,58,0,0,0,63,63,58,0,63,0,57,0,64,63,63,58,0,0,57,0,57,63,57,63,64,64,0,0,63,63,58,0,0,0,0,64,0,0,57,63,57,64,63,63,64,58,64,0,0,0,63,64,0,57,64,0,57,64,0,63,57,64,0,0,0,
57,58,57,57,63,0,64,0,57,0,63,0,0,58,64,0,63,63,58,63,57,57,0,64,58,0,0,0,58,0,64,0,58,57,63,64,63,0,0,63,58,0,63,63,0,63,0,0,64,57,63,63,57,0,64,0,57,63,63,57,0,63,57,0,0,64,0,0,0,58,0,0,0,0,0,0,63,58,63,58,64,0,64,64,0,58,58,0,0,63,64,
58,0,58,0,64,64,58,58,58,57,58,0,0,57,0,0,63,0,57,0,57,63,0,0,64,57,58,0,0,0,63,64,0,63,57,0,57,64,0,57,0,0,0,0,0,0,0,63,0,57,0,0,0,63,0,0,63,57,57,63,58,58,64,0,0,57,64,0,57,58,0,63,57,63,64,0,0,0,57,58,63,0,0,0,0,0,58,0,0,0,63,
0,63,0,58,0,0,57,63,0,64,64,0,0,63,63,63,0,57,0,63,0,57,64,63,0,57,58,0,58,64,58,58,0,58,0,57,58,0,0,57,58,64,0,0,64,58,0,57,0,0,58,57,58,63,58,64,0,64,63,58,64,0,57,58,57,64,0,63,0,0,0,57,64,64,63,0,64,0,0,0,64,64,58,0,0,0,63,58,63,57,0,
0,0,63,0,58,0,58,0,57,0,57,0,58,0,63,57,63,63,63,0,0,57,64,0,58,63,63,0,64,0,58,0,0,0,57,63,63,63,58,64,0,57,57,57,0,0,0,57,64,63,57,57,57,58,63,58,64,0,57,0,63,0,58,0,57,58,64,0,0,64,58,63,57,58,64,0,63,63,0,57,0,0,0,64,58,57,0,58,0,0,63,
57,0,63,58,57,64,57,0,0,0,57,0,57,63,57,58,58,58,0,63,58,64,0,57,64,63,57,0,57,0,58,0,58,64,58,63,0,58,63,64,64,64,57,63,0,64,0,63,0,57,57,63,0,63,57,57,0,57,63,58,57,57,63,58,63,0,0,0,57,0,64,0,0,0,0,0,0,63,0,64,63,0,0,0,58,57,0,0,0,0,58,
0,58,58,57,58,64,0,0,0,64,0,57,64,63,64,64,64,0,58,63,63,0,0,0,0,0,0,0,63,64,0,57,63,58,0,63,64,57,0,0,57,0,58,0,0,58,0,57,64,63,58,0,63,63,0,0,0,0,64,64,63,58,0,58,63,0,57,63,58,0,0,57,0,0,57,0,58,0,63,57,0,58,0,64,57,57,57,0,64,64,0,
