63,0,0,57,0,0,0,0,0,0,0,63,63,63,0,0,0,0,0,64,63,0,63,0,0,0,0,0,0,64,63,0,0,63,
63,57,58,0,57,0,0,0,0,0,0,58,0,64,0,0,0,0,0,57,0,0,0,0,57,0,0,0,57,0,64,63,0,0,
63,58,0,0,0,58,0,64,0,0,64,0,57,57,63,0,0,0,0,64,0,0,64,0,64,0,64,0,0,0,0,58,0,63,
58,58,0,0,57,0,58,58,0,57,0,0,0,58,63,0,57,57,0,0,57,58,0,64,0,57,0,57,0,0,58,0,0,63,
0,0,0,0,0,0,0,58,63,58,0,0,58,0,0,0,0,0,0,64,0,57,63,0,0,58,64,0,0,0,0,0,0,64,
57,0,57,57,0,0,57,58,0,0,0,0,0,0,58,0,64,58,58,0,0,0,64,58,0,0,0,58,58,0,64,58,0,57,
57,58,63,0,57,0,63,58,0,0,57,0,63,0,0,0,63,0,64,0,63,58,0,63,0,0,57,64,57,0,57,0,0,0,
0,0,0,0,0,0,0,64,0,0,0,57,63,58,0,0,0,0,57,64,0,63,63,0,0,57,58,0,0,0,0,0,57,0,
63,64,63,0,57,0,0,63,0,0,0,0,64,58,57,58,0,0,64,57,0,57,58,57,0,0,57,0,0,0,58,0,58,58,
0,58,58,0,0,0,0,0,64,0,57,57,0,57,0,0,0,0,0,64,0,0,0,0,58,0,0,0,0,0,0,0,57,0,
63,0,63,0,0,63,0,0,0,0,58,0,0,0,63,0,57,0,0,58,0,0,63,0,0,0,63,0,0,64,58,0,0,63,
0,63,0,63,0,0,0,0,0,0,63,0,58,57,63,0,58,0,0,0,63,0,0,63,57,0,64,0,0,0,58,0,0,0,
0,0,64,0,64,0,0,57,0,0,0,0,0,64,0,0,0,0,0,0,63,0,0,63,0,57,58,0,0,63,0,63,58,57,
0,0,0,0,63,0,63,0,0,0,0,0,57,63,0,0,58,63,0,64,64,58,0,58,63,0,63,0,0,0,0,0,64,58,
64,0,58,0,0,58,0,0,58,64,0,0,0,57,0,0,0,0,64,0,63,0,0,0,58,0,0,0,0,57,0,57,0,0,
0,63,63,0,0,63,63,63,0,58,0,0,0,57,57,0,58,0,0,0,0,58,0,0,0,0,0,63,64,0,57,0,0,0,
0,0,57,0,57,0,57,64,64,0,0,64,64,58,0,0,0,0,0,0,0,58,0,0,57,57,0,0,0,0,58,0,64,0,
0,0,58,0,0,0,64,0,58,0,58,58,63,0,57,0,64,57,0,0,64,0,63,64,57,57,64,0,0,0,63,63,63,0,
57,64,0,0,0,0,57,0,63,0,63,0,58,0,0,0,0,63,64,0,0,63,57,64,0,58,0,0,64,0,0,0,0,0,
64,0,58,64,0,58,0,0,57,63,0,0,0,58,64,58,0,0,0,0,63,0,57,0,0,0,58,0,57,0,0,0,57,0,
58,0,0,57,57,0,57,63,64,58,0,0,0,0,64,0,0,0,0,57,0,0,0,64,64,0,0,0,0,0,63,0,58,0,
64,0,0,0,0,63,0,0,57,57,58,0,0,0,57,0,0,0,58,0,63,0,57,64,0,0,0,63,63,58,0,58,0,58,
0,64,0,0,64,0,0,0,0,0,0,63,63,0,0,0,0,58,0,0,0,0,0,0,0,0,0,0,64,0,0,0,58,0,
0,63,58,0,0,64,0,0,0,0,0,63,0,0,63,64,0,57,58,64,0,0,0,0,58,63,0,57,64,0,0,58,0,0,
0,0,58,0,64,58,57,0,0,0,58,0,0,0,63,0,63,63,0,57,0,64,57,63,0,64,0,0,58,63,57,0,0,0,
0,0,0,0,0,0,64,64,64,0,0,0,0,0,63,58,0,57,64,0,0,58,0,64,0,0,0,0,63,0,57,57,58,0,
0,0,0,0,58,57,0,64,0,63,0,0,63,58,58,0,58,0,0,63,0,0,0,58,0,0,0,0,57,0,58,0,63,0,
0,0,63,0,0,57,0,57,63,58,0,64,0,0,0,58,0,0,58,63,57,0,58,0,0,0,0,0,0,0,58,0,0,63,
63,0,63,0,0,0,0,0,0,0,0,0,0,63,63,0,64,64,57,58,63,0,63,58,58,64,0,0,0,57,58,0,0,0,
0,57,64,63,63,0,0,58,0,0,0,0,63,57,0,0,57,0,0,0,57,63,0,0,58,0,0,0,57,0,0,58,58,0,
0,64,64,0,0,0,57,58,58,0,0,0,57,58,0,57,0,0,0,57,64,0,58,58,58,0,0,57,0,0,58,0,0,0,
0,0,58,0,63,0,57,0,0,0,0,63,0,0,0,0,0,0,57,0,58,57,0,0,63,0,63,57,58,0,0,0,0,0,
0,0,0,58,57,0,0,57,64,58,63,58,0,64,0,58,0,0,0,0,63,0,64,0,0,0,0,64,0,63,58,0,0,57,
0,63,0,0,58,0,63,0,0,0,0,0,57,0,0,0,58,0,0,0,64,0,58,58,57,64,0,0,0,0,57,0,58,57,
